XXX..114..
...*......
..XX..XXX.
......#...
XXX*......
.....+.58.
..XXX.....
......XXX.
...$.*....
.XXX.XXX..